NO textures/texno.png
SO textures/texno.png
WE textures/texwe.png
EA textures/texea.png

C 000,244,124
F 103,123,028

11111111111111111111111111111
	1000000000110000000000001
	1011000001110000000000101
	1001100000000000000000000111111111
111111111011000001111000000100010011
1000000000110000011101E00111111111111
111101111111110111000000100011
1111011111111101 0101010010001
110000001010101110000001000111
1000000000000011000000100011
10000000000000011101010010001
11000001110101011 111011110011
11110111 111010101 1111010001
11111111 111111111 1111111111