NO      ./src/texture/north.xpm
               SO ./src/texture/south.xpm
   WE          ./src/texture/west.xpm
EA ./src/texture/east.xpm

F 0  ,   0   ,0
C       0,      0,       0

11
111111111111111111111111
1000001100001000000000001
1000110000000000111111011
10001100000E0000110001001
1000000000100000000001001
1111111111111111111111111
