NO ./src/texture/north.xpm
SO ./src/texture/south.xpm
EA ./src/texture/east.xpm
WE ./src/texture/west.xpm

F 1,51,255
C 51,234,255

111111111111111111111
1000000000000000000001111
1000000E000000000000 1
1001111111111111111111                
11111111111111111111111111































































