NO ./src/texture/north.xpm
SO ./src/texture/south.xpm
WE ./src/texture/west.xpm
EA ./src/texture/east.xpm

F 20,20,20
C 200,200,200

11111111
10S01
11111111