NO ./textures/north.xpm
SO ./textures/south.xpm
WE ./textures/west.xpm
EA ./textures/east.xpm

F 51,51,51
C 153,204,255

11111111111111111111111111111111111
10000000000000000000000000000001111
111111E00000000000000000000000011111
11111111111111111111111111111111111