NO ./src/texture/north.xpm
SO ./src/texture/south.xpm
EA ./src/texture/east.xpm
WE ./src/texture/west.xpm

F 51,51,11
C 41,234,255

1111111111111111111111
100000000000000000001111               1
1000000000000000000001                1N1
10011111111111111111111                1
1111111111111111111111111111





























































































