
SO ./src/texture/south.xpm
   WE ./src/texture/west.xpm
C        200,200,                     200

   EA ./src/texture/east.xpm




NO ./src/texture/north.xpm


F 255,                20,             0
1111111111111
100N0000000 1
11111   11101
111111111111
111111111111
