NO ./src/texture/north.xpm
SO ./src/texture/south.xpm
EA ./src/texture/east.xpm
WE ./src/texture/west.xpm                                                                                         

F 220,100,0
C 225,30,0

    11111111111111111111111
    10000000110000000000001
    10110000011100000000001111
    10011000000000000000000001
111111111011000001111000000101
100000000011000001110 1001111111111111
111101111111110111000000100011
1111011111111101 1101010010001
11000000101010111000000100011
1000000S00000001100000010001
10000000000000011101010010001
11000001110101011 111011110011
11110111 111010101 1111010001
11111111 111111111 1111111111


