  SO     ./src/texture/south.xpm
   WE ./src/texture/west.xpm


   EA ./src/texture/east.xpm

NO ./src/texture/north.xpm

F 20,20,20
C 200,200,212


11111111111111111111111
1100000000000000E0000011
11111111111111111111111


