NO ./src/texture/north.xpm
SO ./src/texture/north.xpm
EA ./src/texture/north.xpm
WE ./src/texture/north.xpm

F 20,20,20
C 200,200,255


111111111111111111111111
100000000000000000011111
10000000S0000011110000111
1000000000000010010000111
1111100000000000110000111
1111111111111111111111111
