NO ./src/texture/north.xpm
SO ./src/texture/south.xpm
EA ./src/texture/east.xpm
WE ./src/texture/west.xpm

F 51,51,51
C 153,204,255

11111111111111111111111111111111111
10000000000000000000000000000001111
1111110000000000000000000E000001111
11111111111111111111111111111111111
