NO ./src/texture/north.xpm
SO ./src/texture/south.xpm
EA ./src/texture/east.xpm
WE ./src/texture/west.xpm

F 51,51,11
C 41,234,255

11111111111111111111111111111111111
10000000000000000000000000000001111
0E
11111100000000000000000000011111111
11111111111111111111111111111111111
