NO ./src/texture/north.xpm
SO ./src/texture/south.xpm
EA ./src/texture/east.xpm
WE ./src/texture/west.xpm

F 51,51,11
C 41,234,255

11111111111111111111
100N000001
11111111111111111111
